Cruel Summer - Taylor Swift
Paint The Town Red - Doja Cat
Snooze - SZA
I Remember Everything - Zach Bryan Featuring Kacey Musgraves
Fast Car - Luke Combs
Last Night - Morgan Wallen
Thinkin' Bout Me - Morgan Wallen
IDGAF - Drake Featuring Yeat
Monaco - Bad Bunny
Fukumean - Gunna
Vampire - Olivia Rodrigo
Dance The Night - Dua Lipa
First Person Shooter - Drake Featuring J. Cole
Greedy - Tate McRae
Rich Baby Daddy - Drake Featuring Sexyy Red And SZA
Flowers - Miley Cyrus
Need A Favor - Jelly Roll
Used To Be Young - Miley Cyrus
Barbie World - Nicki Minaj Featuring Ice Spice With Aqua
Anti-Hero - Taylor Swift
Water - Tyla
Virginia Beach - Drake
Religiously - Bailey Zimmerman
What Was I Made For? - Billie Eilish
Good Good - Usher, Summer Walker And 21 Savage
My Love Mine All Mine - Mitski
Save Me - Jelly Roll With Lainey Wilson
Kill Bill - SZA
Dial Drunk - Noah Kahan With Post Malone
What It Is (Block Boy) - Doechii Featuring Kodak Black
Agora Hills - Doja Cat
All My Life - Lil Durk Featuring J. Cole
Daylight - Drake
Bad Idea Right? - Olivia Rodrigo
Lil Boo Thang - Paul Russell
White Horse - Chris Stapleton
Perro Negro - Bad Bunny And Feid
Creepin' - Metro Boomin, The Weeknd And 21 Savage
Slime You Out - Drake Featuring SZA
I Know ? - Travis Scott
Try That In A Small Town - Jason Aldean
Fina - Bad Bunny And Young Miko
Stick Season - Noah Kahan
Too Much - The Kid LAROI, Jung Kook And Central Cee
Watermelon Moonshine - Lainey Wilson
Pretty Little Poison - Warren Zeiders
Qlona - Karol G And Peso Pluma
Single Soon - Selena Gomez
Lose Control - Teddy Swims
Get Him Back! - Olivia Rodrigo
Wild Ones - Jessie Murph And Jelly Roll
Strangers - Kenya Grace
Bongos - Cardi B And Megan Thee Stallion
Rich Men North Of Richmond - Oliver Anthony Music
Great Gatsby - Rod Wave
Meltdown - Travis Scott Featuring Drake
Lady Gaga - Peso Pluma, Gabito Ballesteros And Junior H
On My Mama - Victoria Monet
500lbs - Lil Tecca
Everything I Love - Morgan Wallen
Gently - Drake Featuring Bad Bunny
LaLa - Myke Towers
Un Preview - Bad Bunny
Hey Driver - Zach Bryan Featuring The War And Treaty
SkeeYee - Sexyy Red
Can't Have Mine - Dylan Scott
Truck Bed - HARDY
Segun Quien - Maluma And Carin Leon
Calling For You - Drake Featuring 21 Savage
Turks & Caicos - Rod Wave Featuring 21 Savage
El Amor de Su Vida - Grupo Frontera And Grupo Firme
Hibiki - Bad Bunny And Mora
Mr. October - Bad Bunny
Baby Nueva - Bad Bunny
3D - Jung Kook And Jack Harlow
Burn It Down - Parker McCollum
Better Place - *NSYNC
One Of Your Girls - Troye Sivan
Mi Ex Tenia Razon - Karol G
What Would Pluto Do - Drake
Cybertruck - Bad Bunny
God Gave Me A Girl - Russell Dickerson
Stars Like Confetti - Dustin Lynch
8am In Charlotte - Drake
Que Onda - Calle 24 x Chino Pacas x Fuerza Regida
Boyz Don't Cry - Rod Wave
Telefono Nuevo - Bad Bunny And Luar La L
Fear Of Heights - Drake
Seda - Bad Bunny And Bryant Myers
Standing Room Only - Tim McGraw
One More Time - blink-182
Oklahoma Smokeshow - Zach Bryan
Members Only - Drake Featuring PARTYNEXTDOOR
Tourniquet - Zach Bryan
Call Your Friends - Rod Wave
The Painter - Cody Johnson
Deli - Ice Spice
Bahamas Promises - Drake
Say My Grace - Offset Featuring Travis Scott
